                                                            
 ccccccccccccccccccccccccc ++++++ ccccccccccccccccccccccccc 
 ccccccccccccccccccccccccc ++++++ ccccccccccccccccccccccccc 
 ccccccccccccccccccccccccc ++++++ ccccccccccccccccccccccccc 
 ccccccccccccccccccccccccc        ccccccccccccccccccccccccc 
                                                            
   ########                                     ########    
   ########                                     ########    
   ########                                     ########    
   ########                ppp                  ########    
   ########                ppp                  ########    
   ########                ppp                  ########    
============================================================
============================================================
============================================================
============================================================